@ terminals

#####...#####
#...#...#...#
#...#...#...#
#...#...#...#
#.../.S./...#
#...#...#...#
#####...#####
#.../.../...#
#...##/##...#
#...#...#...#
#...#...#...#
#...#...#...#
#############

#####...#####
#...#...#...#
#.../.../...#
#...#...#...#
#####...#####
#...#...#...#
#.../.S./...#
#...#...#...#
#####...#####
#...#...#...#
#.../.../...#
#...#...#...#
#############

#####...#####
#...#...#...#
#.../.../...#
#...#...#...#
#.S.#...#...#
#...#...#...#
#.../.S./...#
#...#...#...#
#...#...#.S.#
#...#...#...#
#.../.../...#
#...#...#...#
#############


@ straights

#####...#####
#...#...#...#
#...#...#...#
#.../.../...#
#...#...#...#
#...#...#...#
#####.S.#####
#...#...#...#
#...#...#...#
#.../.../...#
#...#...#...#
#...#...#...#
#####...#####

#####...#####
#...#...#...#
#...#...#...#
#.../.../...#
#...#...#...#
#...#...#...#
#.S.#.S.#.S.#
#...#...#...#
#...#...#...#
#.../.../...#
#...#...#...#
#...#...#...#
#####...#####

#####...#####
#...#.......#
#...#.......#
#...#.......#
##/######...#
#.......#...#
#...S.../.S.#
#.......#...#
##/######...#
#...#.......#
#...#.......#
#...#.......#
#####...#####

#####...#####
#...#...#...#
#.../.../...#
#...#...#...#
#####...#####
#...#...#...#
#.../.S./...#
#...#...#...#
#####...#####
#...#...#...#
#.../.../...#
#...#...#...#
#####...#####


@ elbows

#####...#####
#...#...#...#
#.../...#...#
#...#...#...#
#####.../.S.#
........#...#
....S...#...#
........#...#
####/########
#...........#
#.....S.....#
#...........#
#############

#####...#####
#...#...#...#
#...#...#...#
#...#...#...#
##/##.../.S.#
........#...#
.....S..#...#
........#...#
####/########
#...........#
#.....S.....#
#...........#
#############


#####...#####
#.......#...#
#..S..../...#
#.......#...#
#...#####...#
....#...#...#
....#...#.S.#
....#...#...#
##/##...#...#
#.......#...#
#....S..#...#
#.......#...#
#############



@ tees

#####...#####
#...#...#...#
#...#...#...#
#...#...#...#
##/##...##/##
............#
......S.....#
............#
##/##...##/##
#...#...#...#
#...#...#...#
#...#...#...#
#####...#####


#####...#####
#...#...#...#
#...#...#...#
#...#...#...#
##/##...##/##
........#...#
.....S../...#
........#...#
##/##...##/##
#...#...#...#
#...#...#...#
#...#...#...#
#####...#####


@ crosses

#####...#####
#...#...#...#
#.../.../...#
#...#...#...#
#####...#####
.............
......S......
.............
#####...#####
#...#...#...#
#.../.../...#
#...#...#...#
#####...#####


#####...#####
#...........#
#...........#
#.....S.....#
#...#####...#
....#...#....
..../...#....
....#...#....
#...#####...#
#...........#
#...........#
#...........#
#####...#####


