@ terminals

 

#####...#####
#...#...#...#
#...#...#...#
#...#...#...#
#.../.../...#
#...#...#...#
#####...#####
#.../.../...#
#...##/##...#
#...#...#...#
#...#...#...#
#...#...#...#
#############


@ straights


#####...#####
#...#...#...#
#...#...#...#
#...#...#...#
#.../.../...#
#...#...#...#
#####...#####
#...#...#...#
#.../.../...#
#...#...#...#
#...#...#...#
#...#...#...#
#####...#####



@ elbows

#####...#####
#...........#
#.#####/#####
#.#5.......5#
#.#.........#
..#.........#
..#5.......5#
..#######/###
#.#5.......5#
#./.........#
#.#.........#
#.#5.......5#
#############




@ tees

#####...#####
#...#...#...#
#...#...#...#
#...#...#...#
##/##...##/##
...........7#
............#
...........7#
##/##...##/##
#...#...#...#
#...#...#...#
#...#...#...#
#####...#####


@ crosses

######/######
#...#...#...#
#.../.../...#
#...#...#...#
#####...#####
#...........#
/.........../
#...........#
#####...#####
#...#...#...#
#.../.../...#
#...#...#...#
######/######

