@ terminals

#####...#####
#...#...#...#
#...#...#...#
#...#...#...#
#.../.../...#
#...#...#...#
#####...#####
#.../.../...#
#...##/##...#
#...#...#...#
#...#...#...#
#...#...#...#
#############

#####...#####
#...#...#...#
#.../.../...#
#...#...#...#
#####...#####
#...#...#...#
#.../.../...#
#...#...#...#
#####...#####
#...#...#...#
#.../.../...#
#...#...#...#
#############


@ straights

#####...#####
#...#...#...#
#...#...#...#
#.../.../...#
#...#...#...#
#...#...#...#
#####...#####
#...#...#...#
#...#...#...#
#.../.../...#
#...#...#...#
#...#...#...#
#####...#####

#####...#####
#...#.......#
#...#.......#
#...#.......#
##/######...#
#.......#...#
#......./...#
#.......#...#
##/######...#
#...#.......#
#...#.......#
#...#.......#
#####...#####

#####...#####
#...#...#...#
#.../.../...#
#...#...#...#
#####...#####
#...#...#...#
#.../.../...#
#...#...#...#
#####...#####
#...#...#...#
#.../.../...#
#...#...#...#
#####...#####


@ elbows

#####...#####
#...#...#...#
#.../...#...#
#...#...#...#
#####.../...#
........#...#
........#...#
........#...#
####/########
#...........#
#...........#
#...........#
#############

#####...#####
#...#...#...#
#...#...#...#
#...#...#...#
##/##.../...#
........#...#
........#...#
........#...#
####/########
#...........#
#...........#
#...........#
#############


#####...#####
#.......#...#
#......./...#
#.......#...#
#...#####...#
....#...#...#
....#...#...#
....#...#...#
##/##...#...#
#.......#...#
#.......#...#
#.......#...#
#############



@ tees

#####...#####
#...#...#...#
#...#...#...#
#...#...#...#
##/##...##/##
............#
............#
............#
##/##...##/##
#...#...#...#
#...#...#...#
#...#...#...#
#####...#####


#####...#####
#...#...#...#
#...#...#...#
#...#...#...#
##/##...##/##
........#...#
......../...#
........#...#
##/##...##/##
#...#...#...#
#...#...#...#
#...#...#...#
#####...#####


@ crosses

#####...#####
#...#...#...#
#.../.../...#
#...#...#...#
#####...#####
.............
.............
.............
#####...#####
#...#...#...#
#.../.../...#
#...#...#...#
#####...#####


#####...#####
#...........#
#...........#
#...........#
#...#####...#
....#...#....
..../...#....
....#...#....
#...#####...#
#...........#
#...........#
#...........#
#####...#####


