@ terminals

#####...#####
#...#...#...#
#...#...#...#
#...#...#...#
#.../.e./...#
#...#...#...#
#####...#####
#.../.../...#
#...##/##...#
#...#...#...#
#...#...#...#
#...#...#...#
#############

#####...#####
#...#...#...#
#.../.../...#
#...#...#...#
#####...#####
#...#...#...#
#.../.e./...#
#...#...#...#
#####...#####
#...#...#...#
#.../.../...#
#...#...#...#
#############

#####...#####
#...#...#...#
#.../.../...#
#...#...#...#
#.e.#...#...#
#...#...#...#
#.../.e./...#
#...#...#...#
#...#...#.e.#
#...#...#...#
#.../.../...#
#...#...#...#
#############


@ straights

#####...#####
#...#...#...#
#...#...#...#
#.../.../...#
#...#...#...#
#...#...#...#
#####.e.#####
#...#...#...#
#...#...#...#
#.../.../...#
#...#...#...#
#...#...#...#
#####...#####

#####...#####
#...#...#...#
#...#...#...#
#.../.../...#
#...#...#...#
#...#...#...#
#.e.#.e.#.e.#
#...#...#...#
#...#...#...#
#.../.../...#
#...#...#...#
#...#...#...#
#####...#####

#####...#####
#...#.......#
#...#.......#
#...#.......#
##/######...#
#.......#...#
#...e.../.e.#
#.......#...#
##/######...#
#...#.......#
#...#.......#
#...#.......#
#####...#####

#####...#####
#...#...#...#
#.../.../...#
#...#...#...#
#####...#####
#...#...#...#
#.../.e./...#
#...#...#...#
#####...#####
#...#...#...#
#.../.../...#
#...#...#...#
#####...#####


@ elbows

#####...#####
#...#...#...#
#.../...#...#
#...#...#...#
#####.../.e.#
........#...#
....e...#...#
........#...#
####/########
#...........#
#.....e.....#
#...........#
#############

#####...#####
#...#...#...#
#...#...#...#
#...#...#...#
##/##.../.e.#
........#...#
.....e..#...#
........#...#
####/########
#...........#
#.....e.....#
#...........#
#############


#####...#####
#.......#...#
#..e..../...#
#.......#...#
#...#####...#
....#...#...#
....#...#.e.#
....#...#...#
##/##...#...#
#.......#...#
#....e..#...#
#.......#...#
#############



@ tees

#####...#####
#...#...#...#
#...#...#...#
#...#...#...#
##/##...##/##
............#
......e.....#
............#
##/##...##/##
#...#...#...#
#...#...#...#
#...#...#...#
#####...#####


#####...#####
#...#...#...#
#...#...#...#
#...#...#...#
##/##...##/##
........#...#
.....e../...#
........#...#
##/##...##/##
#...#...#...#
#...#...#...#
#...#...#...#
#####...#####


@ crosses

#####...#####
#...#...#...#
#.../.../...#
#...#...#...#
#####...#####
.............
......e......
.............
#####...#####
#...#...#...#
#.../.../...#
#...#...#...#
#####...#####


#####...#####
#...........#
#...........#
#.....e.....#
#...#####...#
....#...#....
..../...#....
....#...#....
#...#####...#
#...........#
#...........#
#...........#
#####...#####


