@ terminals

#...........#
#...........#
#..#.....#..#
#...........#
#...?????...#
#...?????...#
#...?????...#
#...?????...#
#...?????...#
#..#.....#..#
#...........#
#...........#
#############

#...........#
#...........#
#..........7#
#.........7c#
#..........7#
#...........#
######/######
#?????.?????#
#?????.?????#
#?????.?????#
#?????.?????#
#?????.?????#
#############


#...........#
#...........#
#...........#
#...........#
#..........5#
#.........55#
#.....#######
#.....#.....#
#.....#.....#
#...../.....#
#5....#.....#
#55...#.....#
#############

#...........#
#...........#
#...........#
#...........#
#=...=T=...=#
#=...===...=#
#=.........=#
#...?????...#
#...?????...#
#...?????...#
#...?????...#
#...?????...#
#############



@ straights

#...........#
#...........#
#.7.......7.#
#...........#
#........7..#
#...7.......#
#........7..#
#...........#
#.7........7#
#...........#
#.......7...#
#7..........#
#...........#



#...........#
#..........c#
#c..........#
#7..........#
#7.........7#
#...........#
#..........7#
#......?????#
#......?????#
#......?????#
#c.....?????#
#......?????#
#...........#


#...........#
#...........#
#...........#
#...........#
#...#####...#
#...#...#...#
#...#...#...#
#...#...#...#
#...##/##...#
#...........#
#...........#
#...........#
#...........#




@ elbows

............#
..5.........#
.555.......5#
..5........5#
..........55#
.....###/####
.....#......#
.....#.?????#
.....#.?????#
.....#.?????#
....7#.?????#
...7c#.?????#
#############

............#
......?????.#
......?????.#
......?????.#
......?????.#
......?????.#
.......######
.......#....#
.......#..==#
......./..T=#
.......#..!=#
.......#....#
#############
BUTTON_ACTION: FLOOD_WATER
BUTTON_TARGET: 11, 11
BUTTON_INTENSITY: 3
BUTTON_REPS: 5
BUTTON_ONE_USE_ONLY: TRUE

............#
............#
..#####/#####
..#5.......5#
..#.........#
..#.........#
..#5.......5#
..#######/###
..#5.......5#
../.........#
..#.........#
..#5.......5#
#############


............#
............#
......#######
......#?????#
......#?????#
....../?????#
......#?????#
......#?????#
......#######
.........757#
..5.....5565#
.555...57575#
#############



@ tees

............#
.?????......#
.?????......#
.?????...7..#
.?????......#
.?????......#
.......?????#
.......?????#
..7....?????#
.......?????#
....7..?????#
............#
............#

............#
............#
.........####
..........7c#
....22.....7#
....22....7c#
....22.....7#
....22....7c#
...........7#
..........7c#
.........####
............#
............#


............#
............#
.......######
.......#..5w#
.......#...5#
......./..5b#
.......#...5#
.......#..5b#
.......#...5#
.......######
............#
............#
............#



@ crosses

.............
.............
..#########..
..#6....66#..
..#......6#..
..#..?????#..
../..?????#..
..#..?????#..
..#6.?????#..
..#66?????#..
..#########..
.............
.............


.............
.##.......##.
.##7.....7##.
..77.........
.............
.....?????...
.....?????...
.....?????...
.....?????...
.....?????...
.##.......##.
.##.......##.
.............


.............
.77.c7.c7.cc.
.cc.7c.7c.77.
.............
.c7.77.cc.7c.
.7c.cc.77.c7.
.............
.c7.77.cc.7c.
.7c.cc.77.c7.
.............
.cc.7c.77.c7.
.77.c7.cc.7c.
.............


.............
.............
..=========..
..=aaaaaaa=..
..=aaaaaaa=..
..=aaaaaaa=..
..=aaaaaaa=..
..=aaaaaaa=..
..=aaaaaaa=..
..=aaaaaaa=..
..=========..
.............
.............


.............
.............
...:::::::!..
...:.....::..
...:......:..
...:......:..
..7:......:..
..c:......:..
..7:......:..
...:......:..
...::::::::..
.............
.............
BUTTON_ACTION: FLOOD_ACID
BUTTON_TARGET: 4, 3
BUTTON_TARGET: 4, 9
BUTTON_TARGET: 9, 9
BUTTON_INTENSITY: 2
BUTTON_REPS: 7

.............
.............
..:::::::::..
..:?????7.:..
..:?????..:..
..:?????..:..
.7:?????../..
..:?????..:..
..:7......:..
..:.......:..
..:::::::::..
......7......
.............


.............
.............
..##.....##..
..##.....##..
....?????....
....?????....
....?????....
....?????....
....?????....
..##.....##..
..##.....##..
.............
.............


.............
.............
..##::#::##..
..#XXXXXXX#..
..:XXXXXXX:..
..:XXXXXXX:..
..#XXXXXXX#..
..:XXXXXXX:..
..:XXXXXXX:..
..#XXXXXXX#..
..##::#::##..
.............
.............

