@ terminals

#...........#
#...........#
#..#.....#..#
#...........#
#...........#
#...........#
#.....S.....#
#...........#
#...........#
#..#.....#..#
#...........#
#...........#
#############

#...........#
#...........#
#...........#
#.....S.....#
#...........#
#...........#
######/######
#...........#
#...........#
#.....S.....#
#...........#
#...........#
#############


#...........#
#...........#
#...........#
#.....S.....#
#..........5#
#.........55#
#.....#######
#.....#.....#
#.....#.....#
#...../..S..#
#5....#.....#
#55...#.....#
#############

#...........#
#...........#
#...........#
#...........#
#...........#
#.....S.....#
#...........#
#...........#
#...........#
#...........#
#...........#
#...........#
#############



@ straights

#...........#
#...........#
#...........#
#...........#
#...........#
#...........#
#.....S.....#
#...........#
#...........#
#...........#
#...........#
#...........#
#...........#



#...........#
#...........#
#...........#
#...........#
#...#####...#
#...#...#...#
#...#...#S..#
#...#...#...#
#...##/##...#
#...........#
#...........#
#...........#
#...........#




@ elbows

............#
..5.........#
.555.......5#
..5........5#
....S.....55#
.....###/####
.....#......#
.....#......#
.....#...S..#
.....#......#
.....#......#
.....#......#
#############

............#
............#
............#
............#
............#
.......S....#
.......######
.......#....#
.......#....#
......./.S..#
.......#....#
.......#....#
#############


............#
............#
..#####/#####
..#5.......5#
..#.........#
..#....S....#
..#5.......5#
..#######/###
..#5.......5#
../....S....#
..#.........#
..#5.......5#
#############


............#
............#
......#######
......#.....#
......#.....#
....../..S..#
......#.....#
......#.....#
......#######
.....S......#
............#
............#
#############



@ tees

............#
............#
............#
............#
............#
............#
......S.....#
............#
............#
............#
............#
............#
............#

............#
............#
.........####
............#
....22......#
....22S.....#
....22......#
....22......#
............#
............#
.........####
............#
............#


............#
............#
.......######
.......#..5w#
.......#...5#
......./..5b#
......S#...5#
.......#..5b#
.......#...5#
.......######
............#
............#
............#



@ crosses

.............
.............
..#########..
..#6....66#..
..#......6#..
..#.......#..
../....S..#..
..#.......#..
..#6......#..
..#66.....#..
..#########..
.............
.............


.............
.##.......##.
.##.......##.
.............
.............
.............
......S......
.............
.............
.............
.##.......##.
.##.......##.
.............



.............
.............
.............
.............
.............
.............
......S......
.............
.............
.............
.............
.............
.............




.............
.............
..##.....##..
..##.....##..
.............
.............
......S......
.............
.............
..##.....##..
..##.....##..
.............
.............


.............
.............
.............
...##::::##..
...#XXXXXX#..
...:XXXXXX:..
...:XXXXXX:..
...#XXXXXX#..
...##::::##..
.......S.....
.............
.............
.............

