@ enclosed rooms

######/######
#...........#
#...........#
#...........#
#...........#
#...........#
#...........#
#...........#
#...........#
#...........#
#...........#
#...........#
#############

######/######
#...........#
#...........#
#...........#
#...........#
#...........#
/...........#
#...........#
#...........#
#...........#
#...........#
#...........#
#############

######/######
#...........#
#...........#
#...........#
#...........#
#...........#
#...........#
#...........#
#...........#
#...........#
#...........#
#...........#
######/######

######/######
#...........#
#...........#
#...........#
#...........#
#...........#
/.........../
#...........#
#...........#
#...........#
#...........#
#...........#
#############

######/######
#...........#
#...........#
#...........#
#...........#
#...........#
/.........../
#...........#
#...........#
#...........#
#...........#
#...........#
######/######

@ open rooms

#...........#
#...........#
#...........#
#...........#
#...........#
#...........#
#...........#
#...........#
#...........#
#...........#
#...........#
#...........#
#############

............#
............#
............#
............#
............#
............#
............#
............#
............#
............#
............#
............#
#############

#...........#
#...........#
#...........#
#...........#
#...........#
#...........#
#...........#
#...........#
#...........#
#...........#
#...........#
#...........#
#...........#

#............
#............
#............
#............
#............
#............
#............
#............
#............
#............
#............
#............
#............

.............
.............
.............
.............
.............
.............
.............
.............
.............
.............
.............
.............
.............

@ small rooms

#####...#####
#####...#####
##.........##
##.........##
##.........##
##.........##
##.........##
##.........##
##.........##
##.........##
##.........##
#############
#############

#####...#####
#####...#####
##.........##
##.........##
##.........##
...........##
...........##
...........##
##.........##
##.........##
##.........##
#############
#############

#####...#####
#####...#####
##.........##
##.........##
##.........##
##.........##
##.........##
##.........##
##.........##
##.........##
##.........##
#####...#####
#####...#####

#####...#####
#####...#####
##.........##
##.........##
##.........##
.............
.............
.............
##.........##
##.........##
##.........##
#############
#############

#####...#####
#####...#####
##.........##
##.........##
##.........##
.............
.............
.............
##.........##
##.........##
##.........##
#####...#####
#####...#####

@ hallways

#####...#####
#####...#####
#####...#####
#####...#####
#####...#####
........#####
........#####
........#####
#############
#############
#############
#############
#############

#####...#####
#####...#####
#####...#####
#####...#####
#####...#####
#####...#####
#####...#####
#####...#####
#####...#####
#####...#####
#####...#####
#####...#####
#####...#####

#####...#####
#####...#####
#####...#####
#####...#####
#####...#####
#####........
#####........
#####........
#####...#####
#####...#####
#####...#####
#####...#####
#####...#####

#####...#####
#####...#####
#####...#####
#####...#####
#####...#####
.............
.............
.............
#####...#####
#####...#####
#####...#####
#####...#####
#####...#####


